1111111111111111111111111111111111111111
1000000000000000000000000000000000000001
1000000000000000000000000000000000001111
1000000000000000000000000000000000001
1000000000001111100000000000000000111
100000000000111111111111111111111111111
10000000000011111111
10000000000000000001
10000000000000000001
10000000000000000001
101110011000000001111
10000000000000000001
10000000000000000001
10000000000011111111
1000000000001
10000000000011111111
10000000000000000001
10000000000000000001
10000000000000000001
111110000000000000111
10000000000000000001
10000000000000000001
10000000000011111111
1000000000001
10000000000011111111
10000000000000000001
10000000000000000001
10000000000000000001
11111111111111111111