NO ./sprite/circle50.png
WE ./sprite/circle50.png
EA ./sprite/circle50.png
SO ./sprite/circle50.png

F 150,250,50
C 40,50,250

11111111111111
100000000000W1
10011111111111
10000000000001
10000000000011
11111111111111