SO ./sprite/circle50.png


WE ./sprite/circle50.png


EA ./sprite/circle50.png


NO ./sprite/flatcircle.png

F 220,100,100

C 225,30,150

111111
100001
101111
0D0111
101111
100001
1000W1
111111