SO ./sprite/circle50.png


WE ./sprite/circle50.png


EA ./sprite/circle50.png


NO ./sprite/flatcircle.png

F 220,100,100

C 225,30,150

1111111111
1000000001
1N11111101
1111111101
1000000001
1111111111