SO ./textures/wall/circle50.png


WE ./textures/wall/circle50.png


EA ./textures/wall/circle50.png


NO ./textures/wall/flatcircle.png

F 220,100,100

C 225,30,150

111111
1D0001
101111
101111
101111
101111
1N1111
111111