SO ./sprite/circle50.png


WE ./sprite/circle50.png


EA ./sprite/circle50.png


NO ./sprite/flatcircle.png

F 220,100,100

C 225,30,150

111111
1E0D01
111111