SO ./textures/wall/template.png


WE ./textures/wall/template(1).png


EA ./textures/wall/template(2).png


NO ./textures/wall/template(3).png

CE ./textures/wall/blue.png

FL ./textures/wall/parquet.png

C 0,0,1

F 169,131,7

        1111111111111111111111111   11111
        100000000011000000D0000W1   10001
        1011000001110000011100001   11111
        100100000000000001 100001
111111111011000001110000011100001
100000000011000001110111111111111
11110111111111011100000000001
11110111111111011101010010001
11000000110101011100000010001
10000000000000000000000010001
10000000000000001101010010001
1100000111010101111101111000111
11110111 1110101 100000010001
11111111 1111111 111111111111