SO ./textures/wall/x.png


WE ./textures/wall/x.png


EA ./textures/wall/x.png


NO ./textures/wall/x.png

F 255,255,0

C 225,30,150

        1111111111111111111111111   11111
        1000000000110000000000001   10001
        1011000001110000011100001   11111
        100100000000000001 100001
111111111011000001110000011100001
100000000011000001110111111111111
11110111111111011100000000001
11110111111111011101010010001
11000000110101011100000010001
10000000000000000000000010001
10000000000000001101010010N01
1100000111010101111101111000111
11110111 1110101 100000010001
11111111 1111111 111111111111


