NO ./sprite/wall_1.png
SO ./sprite/wall_2.png
WE ./sprite/wall_3.png
EA ./sprite/wall_4.png
F 220,100,0
C 225,30,0
111111
100100
102001
1100N1
111111
