NO ./textures/wall/wall_1.png

SO ./textures/wall/wall_2.png


WE ./textures/wall/wall_3.png
EA ./textures/wall/wall_4.png




F 220,100,0
C 225,30,0

FL ./textures/wall/floor_1.png





CE ./textures/wall/blue.png















111111111111111
100000E00000001
111111111111111


111111111111111