NO ./sprite/wall_1.png
SO ./sprite/wall_2.png
WE ./sprite/wall_3.png
EA ./sprite/wall_4.png
F 220,100,0
C 225,30,0

111111111111111111111111
111111111111011111111111
111111111111D11111111111
111111111111011111111111
111111111111011111111111
100000D00000D00000D00001
111111111111011111111111
111111111111011111111111
111111111111011111111111
111111111111D11111111111
111111111111011111111111
111111111111011111111111
111111111111111111111111
