NO 	  ./sprite/wall_1.png
SO  		 ./sprite/wall_2.png
WE    ./sprite/wall_3.png
EA                       ./sprite/wall_4.png
F 	220,	100,       0
C 225, 30,	0

111111 111111
100101 100101
101001 101001
1100N1 110001
111111 111111
             
111111 111
100101 101
101001 111
110001
111111
